 ...................
 .                  
 .                  
 .  ????       ???? 
 .                  
 .  ++++       ++++ 
 .  ????  ???  ???? 
 .         *        
 .         .        
 .  ????  ???  ???? 
 .?                 
   .                
   .????   ?   ???? 
   .++++++++++++++++
....................

