 ...................
 ? ?.? ?.? ?.? ?.? ?
 +++.+++.+++.+++.+++
  . . . . . . . . . 
  . . . . . . . . . 
  . . . . . . . . . 
  . . . . . . . . . 
  . . . . . . . . . 
  . . . . . . . . . 
  . . . . . . . . . 
  . . . . . . . . . 
  .?. .?. .?. .?. . 
                  . 
                  .*
. . . . . . . . . . 

