 ...................
 .??? ??? ??? ??? * 
 .                  
 .                  
 .        zzz ???   
 .        ???       
 .            zzz z 
 .    ???     ??? ? 
 .        zzz       
 .        ???       
 .            ???   
 .                  
                    
                 z  
..???.???.???.???.?.

