 ...................
 .          zzz     
 .  ...............?
 . +++      ?  .+++ 
 .?...+    ?+  .... 
 ..    +  ?+   .+++ 
 .      +?+    .... 
 .      ?+  ? ..+++ 
 .     ?   ?  .++++ 
 .    ?   ?   ..... 
 .       ?    .++++ 
        ?     ..... 
       ?      .++++ 
      ?     z .*+++ 
................... 

